1111111111111111111111111111111111
1001000000000000C00000C00000000001
1010010100100000101001000000010101
1000000010101010001001000001010111
100100000C00C000C000000000000000C1
1111111111111111111111111101111111
100000P0E0000000000000000000000011
1111111111111111111111111111111111
